
F 35,190,73





SO                  textures/SO.xpm


EA textures/EA.xpm

       NO         textures/NO.xpm

C 255,255,255

                WE textures/WE.xpm




111111111111111
111111000111111
111110000011111
111100000001111
111000000000111
1100000S0000011
100001111100001
 111111 1111111
 11111   11111
  1111   1111
  11111 11111
110000111000011
111000010000111
111100000001111
111110000011111
111111000111111
111111111111111





