NO 12 12 12
SO 12 12 12
WE 12 12 12
EA 12 12 12

C 1.1.1
F 1.1.1

111111111111111111111
1                   1
111111111111111111111